6 12
50
############
#..........#
#....##....#
#....##....#
#....#.....#
############
